WWWWWWWWWWWWWWWWWWWWWWWWW
WOOXXXXXXXXXXXXXXXXXXXOOW
WOWXWXWXWXWXWXWXWXWXWXWOW
WXXXXXXXXXXXXXXXXXXXXXXXW
WXWXWXWXWXWXWXWXWXWXWXWXW
WXXXXXXXXXXXXXXXXXXXXXXXW
WXWXWXWXWXWXWXWXWXWXWXWXW
WXXXXXXXXXXXXXXXXXXXXXXXW
WXWXWXWXWXWXWXWXWXWXWXWXW
WXXXXXXXXXXXXXXXXXXXXXXXW
WXWXWXWXWXWXWXWXWXWXWXWXW
WXXXXXXXXXXXXXXXXXXXXXXXW
WXWXWXWXWXWXWXWXWXWXWXWXW
WXXXXXXXXXXXXXXXXXXXXXXXW
WXWXWXWXWXWXWXWXWXWXWXWXW
WXXXXXXXXXXXXXXXXXXXXXXXW
WXWXWXWXWXWXWXWXWXWXWXWXW
WXXXXXXXXXXXXXXXXXXXXXXXW
WOWXWXWXWXWXWXWXWXWXWXWOW
WOOXXXXXXXXXXXXXXXXXXXOOW
WWWWWWWWWWWWWWWWWWWWWWWWW
