WWWWWWWWWWWWWWWWWWWWWWWWW
WOOXXXXXXXXXXXXXXXXXXXOOW
WOXXXXXXXXXXWXXXXXXXXXXOW
WXXXXXXXXXXXWXXXXXXXXXXXW
WXXXXXXXXXXXWXXXXXXXXXXXW
WXXXXXXXXXXXWXXXXXXXXXXXW
WXXXXXXXXXXXWXXXXXXXXXXXW
WXXXXXXXXXXXWXXXXXXXXXXXW
WXXXXXXXXXXXWXXXXXXXXXXXW
WXXXXXXXXXXXWXXXXXXXXXXXW
WXWWWWWWWWWWWWWWWWWWWWWXW
WXXXXXXXXXXXWXXXXXXXXXXXW
WXXXXXXXXXXXWXXXXXXXXXXXW
WXXXXXXXXXXXWXXXXXXXXXXXW
WXXXXXXXXXXXWXXXXXXXXXXXW
WXXXXXXXXXXXWXXXXXXXXXXXW
WXXXXXXXXXXXWXXXXXXXXXXXW
WXXXXXXXXXXXWXXXXXXXXXXXW
WOXXXXXXXXXXWXXXXXXXXXXOW
WOOXXXXXXXXXXXXXXXXXXXOOW
WWWWWWWWWWWWWWWWWWWWWWWWW
