WWWWWWWWWWWWWWWWWWWWWWWWW
WOOOXXXXXXXXXXXXXXXXXXXXW
WOWOWXWXWXWXWXWXWXWXWXWXW
WOOOOXXXXXXXXXXXXXXXXXXXW
WOWXWXWXWXWXWXWXWXWXWXWXW
WXXXXXXXXXXXXXXXXXXXXXXXW
WXWXWXWXWXWXWXWXWXWXWXWXW
WXXXXXXXXXXXXXXXXXXXXXXXW
WXWXWXWXWXWXWXWXWXWXWXWXW
WXXXXXXXXXXXXXXXXXXXXXXXW
WXWXWXWXWXWXWXWXWXWXWXWXW
WXXXXXXXXXXXXXXXXXXXXXXXW
WXWXWXWXWXWXWXWXWXWXWXWXW
WXXXXXXXXXXXXXXXXXXXXXXXW
WXWXWXWXWXWXWXWXWXWXWXWXW
WXXXXXXXXXXXXXXXXXXXXXXXW
WXWXWXWXWXWXWXWXWXWXWXWXW
WXXXXXXXXXXXXXXXXXXXXXXXW
WXWXWXWXWXWXWXWXWXWXWXWXW
WXXXXXXXXXXXXXXXXXXXXXXXW
WWWWWWWWWWWWWWWWWWWWWWWWW
